0 0 0 0 0 0 0 0 0 0 0 0 0 0 0 0 0 0 0 0
0 0 0 1 2 3 4 5 0 0 0 0 0 0 0 0 0 0 0 0
0 0 0 32 33 34 35 36 37 0 0 0 0 0 0 0 0 0 0 0
0 0 0 96 97 98 99 100 101 0 0 0 0 0 0 0 0 0 0 0
0 0 0 96 97 98 99 98 34 34 34 35 36 0 0 0 0 0 0 0
0 0 0 128 129 131 131 131 131 131 131 131 132 0 0 0 0 0 0 0 
0 0 0 0 0 0 0 0 0 0 0 0 0 0 0 0 0 0 0 0
0 0 0 0 0 0 0 0 0 0 0 0 0 0 0 0 0 0 0 0
0 0 0 0 0 0 0 0 0 0 0 0 0 0 0 0 0 0 0 0
0 0 0 0 0 0 0 6 193 193 194 193 193 196 7 0 0 0 0 0
0 0 0 0 0 0 0 38 24 25 26 27 28 29 39 0 0 0 0 0
0 0 0 0 0 0 0 38 56 57 58 59 60 61 39 0 0 0 0 0
0 0 0 0 0 0 0 38 56 59 59 59 58 61 39 0 0 0 0 0
0 0 0 0 0 0 0 38 184 185 186 187 188 189 39 0 0 0 0 0
0 0 0 0 0 0 0 224 225 225 226 227 228 225 229 0 0 0 0 0 
0 0 0 0 0 0 0 0 0 0 0 0 0 0 0 0 0 0 0 0
0 0 0 0 0 0 0 0 0 0 0 0 0 0 0 0 0 0 0 0
0 0 0 0 0 0 0 0 0 0 0 0 0 0 0 0 0 0 0 0
0 0 0 0 0 0 0 0 0 0 0 0 0 0 0 0 0 0 0 0
0 0 0 0 0 0 0 0 0 0 0 0 0 0 0 0 0 0 0 0